AATCATAGAC	TGGCGTCATTTTCCCCAATCATAGACTGTTGAAAGTGAAC
AAAGTGAACA	CCCAATCATAGACTGTTGAAAGTGAACAAAACTGAT
AAAACTGATG	AGACTGTTGAAAGTGAACAAAACTGATGACTATCGTGCCACATTGA
AAACTGATGA	AAACTGATGACTATCGTGCCACATTGAT
AACTGATGAC	AACTGATGACTATCGTGCCACATTGATT
ACATTGATTG	ACTGATGACTATCGTGCCACATTGATTGTTGTCGGTGCCTCGCTTC
ATTGATTGTT	CATTGATTGTTGTCGGTGCCTCGCTTCTG
ATTGTTGTCG	TTGATTGTTGTCGGTGCCTCGCTTCTGAACG
CCTCGCTTCT	TTGTTGTCGGTGCCTCGCTTCTGAACGACCCC
AACGACCCCT	GTCGGTGCCTCGCTTCTGAACGACCCCT
AAAATTGGTC	CCCGAATACAAAATTGGTCTTTGGCGAAACGATTGGA
AAACGATTGG	AAATTGGTCTTTGGCGAAACGATTGGAAACCCGGC
AAACCCGGCG	CTTTGGCGAAACGATTGGAAACCCGGCGCTTGGCGTTCTGGATTTC
AACCCGGCGC	AACCCGGCGCTTGGCGTTCTGGATTTCG
ACCCGGCGCT	ACCCGGCGCTTGGCGTTCTGGATTTCGA
CCCGGCGCTT	CCCGGCGCTTGGCGTTCTGGATTTCGAA
CCGGCGCTTG	CCGGCGCTTGGCGTTCTGGATTTCGAAA
ATTTCGAAAA	CGGCGCTTGGCGTTCTGGATTTCGAAAAGTTCT
AAAAGTTCTC	TTGGCGTTCTGGATTTCGAAAAGTTCTCGAAGCTTGCCAAGGAATT
AAAGTTCTCG	AAAGTTCTCGAAGCTTGCCAAGGAATTC
AAGCTTGCCA	AAGTTCTCGAAGCTTGCCAAGGAATTCGATGTGC
AGGCGTTCGC	CGTCGAGGCGTTCGCGCAGTGGCGGCACGCGCA
AGTGGCGGCA	GGCGTTCGCGCAGTGGCGGCACGCGCATT
ACGCGCATTA	CGTTCGCGCAGTGGCGGCACGCGCATTATTATCATGCTGGTGCGGG
ATCATGCTGG	CGCGCATTATTATCATGCTGGTGCGGGGGTAGGGGTCTT
AGGGGTCTTC	TCATGCTGGTGCGGGGGTAGGGGTCTTCACGGAAGTT
ACGGAAGTTG	GCGGGGGTAGGGGTCTTCACGGAAGTTGCCT
AAGTTGCCTT	GGGTAGGGGTCTTCACGGAAGTTGCCTTTGGCTATTTCAGCGGGTC
AGTTGCCTTT	AGTTGCCTTTGGCTATTTCAGCGGGTCG
AGCGGGTCGT	GTTGCCTTTGGCTATTTCAGCGGGTCGT
AATTGACAGA	GAATTGACAGACGGCATGGTATGAGATAT
ACAGACGGCA	ATTGACAGACGGCATGGTATGAGATATTGTTA
ACGGCATGGT	CAGACGGCATGGTATGAGATATTGTTAGTGG
AGATATTGTT	CGGCATGGTATGAGATATTGTTAGTGGTGATAGGGCTTTC
AGGGCTTTCT	GATATTGTTAGTGGTGATAGGGCTTTCTGTCTGGATCCGGAAAGGC
ATCCGGAAAG	GGGCTTTCTGTCTGGATCCGGAAAGGCGTA
AAAGGCGTAA	CTTTCTGTCTGGATCCGGAAAGGCGTAAAGGAATC
AAAGGAATCC	CTGGATCCGGAAAGGCGTAAAGGAATCCGGGCCGGCAGAATAGCGG
AAGGAATCCG	AAGGAATCCGGGCCGGCAGAATAGCGGG
ACACCTATCT	GACGACACCTATCTGCCCTCCGAAGAAACCG
AAGAAACCGA	ACACCTATCTGCCCTCCGAAGAAACCGAGC
AAACCGAGCA	CCTATCTGCCCTCCGAAGAAACCGAGCATATGTCAGGCGGAGGGGT
AACCGAGCAT	AACCGAGCATATGTCAGGCGGAGGGGTC
ACCGAGCATA	ACCGAGCATATGTCAGGCGGAGGGGTCG
AGCATATGTC	CCGAGCATATGTCAGGCGGAGGGGTCGATGA
AGGCGGAGGG	GCATATGTCAGGCGGAGGGGTCGATGAGAGCGAGC
AGAGCGAGCT	CAGGCGGAGGGGTCGATGAGAGCGAGCTTGGAAGAAACGG
AAGAAACGGC	CGATGAGAGCGAGCTTGGAAGAAACGGCTT
AAACGGCTTC	TGAGAGCGAGCTTGGAAGAAACGGCTTCCGCGAATCGGGGGGAGG
AAATATTCCG	GAGCACTACGAAATATTCCGGATCCGGATGCAGACCGA
AATATTCCGG	AATATTCCGGATCCGGATGCAGACCGAG
ATATTCCGGA	ATATTCCGGATCCGGATGCAGACCGAGG
AGACCGAGGC	TATTCCGGATCCGGATGCAGACCGAGGCT
ACCGAGGCTT	TTCCGGATCCGGATGCAGACCGAGGCTTTCAGAAAGTGTAG
AAAGTGTAGT	GCAGACCGAGGCTTTCAGAAAGTGTAGTCGACGTCATGACTTTGGT
AAGTGTAGTC	AAGTGTAGTCGACGTCATGACTTTGGTA
ACGTCATGAC	AGTGTAGTCGACGTCATGACTTTGGTATCTCCCTGTTT
ACTTTGGTAT	CGTCATGACTTTGGTATCTCCCTGTTTACGGGCAA
ATCTCCCTGT	CTTTGGTATCTCCCTGTTTACGGGCAAG
ACGGGCAAGG	TTTGGTATCTCCCTGTTTACGGGCAAGGGAGA
AATCTTGCTG	TTTCTTCCTAATCTTGCTGAGATGATGAAAGTTAAT
AAAGTTAATG	AATCTTGCTGAGATGATGAAAGTTAATGGCAAAATATAC
AAAATATACA	ATGATGAAAGTTAATGGCAAAATATACAGGGCGATTCCGGAGTTCG
AAATATACAG	AAATATACAGGGCGATTCCGGAGTTCGG
AATATACAGG	AATATACAGGGCGATTCCGGAGTTCGGT
ACAGGGCGAT	ATATACAGGGCGATTCCGGAGTTCGGTATTAA
AGGGCGATTC	CAGGGCGATTCCGGAGTTCGGTATTAAAA
AGTTCGGTAT	GGGCGATTCCGGAGTTCGGTATTAAAACATAT
AAAACATATA	ATTCCGGAGTTCGGTATTAAAACATATATTGTAAGAGAAAGATTTG
AAACATATAT	AAACATATATTGTAAGAGAAAGATTTGC
AAGGATGACA	TGAGAATAAGGATGACATGACTAATCACATCAGGA
AATCACATCA	AGGATGACATGACTAATCACATCAGGAATGCCTATGTCGTAG
AATGCCTATG	ATCACATCAGGAATGCCTATGTCGTAGGTATTGAAGACC
AGGTATTGAA	ATGCCTATGTCGTAGGTATTGAAGACCTTG
AAGACCTTGC	CCTATGTCGTAGGTATTGAAGACCTTGCTCTGAACAATGGT
AACAATGGTG	ATTGAAGACCTTGCTCTGAACAATGGTGTTTGTGATCACGACTGCA
AATGGTGTTT	ACAATGGTGTTTGTGATCACGACTGCAACG
AAAGATAACA	AGCAAAGATAACACCACCATCGTAAACGGAG
AACACCACCA	AAGATAACACCACCATCGTAAACGGAGC
AAACGGAGCA	AGATAACACCACCATCGTAAACGGAGCAGGCAATAAAGAAGCGATC
AAAGAAGCGA	AACGGAGCAGGCAATAAAGAAGCGATCACGAACCGAGTGGCTC
AACCGAGTGG	AAGAAGCGATCACGAACCGAGTGGCTCAGATCAAAGCACAG
AAAGCACAGA	AACCGAGTGGCTCAGATCAAAGCACAGATCGCTGCTACCAAATCGA
AAGCACAGAT	AAGCACAGATCGCTGCTACCAAATCGAC
AAATCGAAGA	TCTCTAAATCGAAGACCATCACTTGAAATTAAT
AAGACCATCA	AATCGAAGACCATCACTTGAAATTAATT
AAATTAATTT	ATCGAAGACCATCACTTGAAATTAATTTTTTAATTGTTGGAGAAAA
AATTAATTTT	AATTAATTTTTTAATTGTTGGAGAAAAT
AATTGTTGGA	ATTAATTTTTTAATTGTTGGAGAAAATTCAT
AAAATTCATA	ATTTTTTAATTGTTGGAGAAAATTCATAATAGTCTTGTAATCCCAT
AAATTCATAA	AAATTCATAATAGTCTTGTAATCCCATG
AATAGTCTTG	AATTCATAATAGTCTTGTAATCCCATGGATGGTCC
AATCCCATGG	ATAGTCTTGTAATCCCATGGATGGTCCATTATTTCTAC
ATCCCATGGA	ATCCCATGGATGGTCCATTATTTCTACC
ATGGATGGTC	TCCCATGGATGGTCCATTATTTCTACCCAT
